1111111111111111111111111111111111
1000000C100000P0000000000000000001
1000000100CC0000000000000000001101
1000000000000000000000110000001101
1000000000000000000011001100001101
1000001100000000000000000000001101
1000000000000000110001100011001101
1000111111000000110001100011001101
1000110011000000110001100011001101
1000111111001111111111111111001101
1000000011001100000000000000000001
1111111110001100000000000000000001
1000000000110000000000000000000001
1000000001100000000000000000000001
1000001111000000000000000000000001
1000000000000000000000000000000001
1010010010101010001001000000010101
1E1000000000C000000000000000011101
1111111111111111111111111111111111