111111111111111111
1P00000C0000000E01
100010010000011111
100010010000000111
1000100100000000C1
111111111111111111