1111111111111111111111111111111111
10000000100000P0000C000C000000C001
100L000100CC0000000000L00000001101
100L00000L000000000000110000001101
10000C000000E00C000011001100001101
1000001100000000000000000000001101
1000000000000000110001100011001101
1000111111000000110001100011001101
1000110011000000110001100011001101
1000111111001111111111111111001101
1000000011001100000000000000000001
1111111110001100000000000000000001
10000C0000110000000000000L00000001
100000000110000L000000L00000000001
10000011110000000000C0000C00000001
1000000C0000000C000000000000000001
10100100101010100010010C0000010101
1010000000000000000000000000011101
1111111111111111111111111111111111