111111111111111111
1P0000000000000001
100000000000000001
10C000000000000001
100000000000000001
100000000000000001
100000000000000001
1000000000E0000001
100000000000000001
100000000000000001
100000000000000001
111111111111111111